XXXXXEXXXXX
   X       
 X   XXXXX 
 X X X   X 
 XXXXXXX   
 X X   XXX 
XX X X X   
   XXX   XX
 XXX X XXX 
 X   X   X 
 X X XXX X 
   X       
XXXXX@XXXXX
